tileset,overworld
tileperline,18
tilelines,8
mwidth,16
mheight,11
55,55,55,55,55,18,55,55,55,55,55,55,55,55,55,55
55,55,55,55,55,18,55,55,55,55,55,55,55,55,55,55
55,56,2,2,2,2,2,2,2,2,2,2,2,2,2,2
55,2,2,2,2,2,2,2,2,2,2,2,2,2,2,2
56,2,2,2,2,2,2,20,2,20,2,20,2,20,2,2
2,2,2,2,2,2,2,2,2,2,2,2,2,2,2,2
38,2,2,2,2,2,2,20,2,20,2,20,2,20,2,2
55,2,2,2,2,2,2,2,2,2,2,2,2,2,2,2
55,38,2,2,2,2,2,2,2,2,2,2,2,2,2,2
55,55,37,18,37,37,37,37,37,37,37,37,37,37,37,37
55,55,55,18,55,55,55,55,55,55,55,55,55,55,55,55
