tileset,overworld
tileperline,18
tilelines,8
mwidth,16
mheight,11
25,25,25,25,25,25,25,25,25,25,25,25,25,25,25,25
25,25,25,25,25,25,25,25,25,25,25,25,25,25,25,25
25,25,8,8,8,8,8,8,8,8,8,8,8,8,8,8
25,8,8,25,25,25,8,8,8,8,8,8,8,8,8,8
8,8,8,8,8,8,8,8,8,8,25,25,25,25,8,8
8,8,8,25,25,25,8,25,25,8,8,8,8,8,8,8
8,8,8,8,8,8,8,8,8,8,25,25,25,25,8,8
25,8,8,25,25,25,8,8,8,8,8,8,8,8,8,8
25,25,8,8,8,8,8,8,8,8,8,8,8,8,8,8
25,25,25,25,25,25,25,25,25,25,25,25,25,25,25,25
25,25,25,25,25,25,25,25,25,25,25,25,25,25,25,25
