tileset,overworld
tileperline,18
tilelines,8
mwidth,16
mheight,11
55,55,55,55,55,55,55,55,55,18,55,55,55,55,55,55
55,55,55,55,55,55,55,55,55,18,55,55,55,55,55,55
2,2,2,54,55,55,55,55,55,18,55,55,55,55,56,2
5,2,2,2,54,55,55,55,55,18,55,55,55,56,2,2
23,2,2,2,2,54,55,55,55,18,55,55,56,2,2,2
2,2,2,2,2,2,2,2,2,2,2,2,2,2,2,2
2,2,2,2,2,2,2,2,2,2,2,2,2,2,2,2
2,2,2,2,2,2,2,2,2,2,2,2,2,2,2,2
2,2,2,2,2,2,2,2,2,2,2,2,2,2,2,2
37,37,37,37,37,37,37,37,37,37,37,37,37,37,37,37
55,55,55,55,55,55,55,55,55,55,55,55,55,55,55,55
