tileset,overworld
tileperline,18
tilelines,8
mwidth,16
mheight,11
61,61,8,8,8,97,97,8,8,8,61,8,61,8,61,61
61,62,8,8,8,97,97,8,8,8,61,8,61,8,60,61
8,8,8,8,8,91,91,8,8,8,8,8,8,8,8,8
8,8,8,8,8,91,91,8,8,8,1,8,8,8,8,8
8,8,8,8,8,91,91,8,8,8,8,8,1,8,8,8
8,8,8,8,8,131,131,8,8,8,1,8,8,8,8,8
8,8,8,8,8,91,91,8,8,8,8,8,1,8,8,8
8,8,8,8,8,91,91,8,8,8,1,8,8,8,8,8
8,8,8,8,8,91,91,8,8,8,8,8,8,8,8,8
43,43,43,44,8,97,97,43,43,43,43,43,43,43,43,43
61,61,61,61,8,97,97,61,61,61,61,61,61,61,61,61
