tileset,overworld
tileperline,18
tilelines,8
mwidth,16
mheight,11
97,97,97,97,97,97,98,8,8,25,25,25,25,25,25,25
97,97,97,97,97,97,98,8,8,25,25,25,25,25,25,25
97,97,97,97,97,97,98,8,8,8,8,8,8,25,25,25
97,97,97,97,97,97,98,8,8,8,8,8,8,25,25,25
115,115,115,115,115,115,116,8,8,8,8,8,8,25,25,25
8,8,8,8,8,8,8,8,8,8,8,8,8,25,25,25
8,8,8,8,8,8,8,8,8,8,8,8,8,25,25,25
25,25,25,8,8,8,8,8,8,8,8,8,8,25,25,25
25,25,25,8,8,8,8,8,8,8,8,8,8,25,25,25
25,25,25,25,25,25,25,8,8,25,25,25,25,25,25,25
25,25,25,25,25,25,25,8,8,25,25,25,25,25,25,25
