tileset,overworld
tileperline,18
tilelines,8
mwidth,16
mheight,11
61,61,25,8,25,8,25,8,8,25,8,25,8,25,8,25
61,61,25,8,25,8,25,8,8,25,8,25,8,25,8,25
61,62,8,8,8,8,8,8,8,8,8,8,8,8,8,25
62,8,8,8,25,8,8,8,8,25,8,8,8,25,8,25
8,8,25,8,8,8,8,8,8,8,8,8,8,8,8,8
8,8,8,8,25,8,25,8,8,25,8,25,8,25,8,8
8,8,25,8,8,8,8,8,8,8,8,8,8,8,8,8
44,8,8,8,25,8,8,8,8,25,8,8,8,25,8,25
61,44,8,8,8,8,8,8,8,8,8,8,8,8,8,25
61,61,25,8,25,8,25,8,8,25,8,25,8,25,8,25
61,61,25,8,25,8,25,8,8,25,8,25,8,25,8,25
